shoes	achievement
tires	achievement
people	achievement
day	achievement
clothes	achievement
glasses	achievement
job	achievement
work	achievement
year	achievement
car	achievement
months	achievement
night	achievement
things	achievement
weekend	achievement
week	achievement
record	achievement
pair	achievement
recipe	achievement
money	achievement
yard work	achievement
month	achievement
weeks	achievement
job offer	achievement
time	achievement
cell phone	achievement
camera	achievement
song	achievement
ideas	achievement
days	achievement
skills	achievement
place	achievement
phone	achievement
running shoes	achievement
years	achievement
credit card	achievement
class	achievement
client	achievement
bed	achievement
trick	achievement
website	achievement
brand car	achievement
project	achievement
ones	achievement
computer	achievement
company	achievement
music	achievement
parts	achievement
speakers	achievement
items	achievement
tv	achievement
plants	achievement
score	achievement
smartphone	achievement
part time job	achievement
vehicle	achievement
way	achievement
grades	achievement
album	achievement
friends	achievement
set	achievement
watch	achievement
kitten	achievement
keyboard	achievement
flavor	achievement
equipment	achievement
job position	achievement
moment	achievement
food	achievement
job interview	achievement
jobs	achievement
hours	achievement
summer	achievement
part time work	achievement
school work	achievement
video game	achievement
minute	achievement
school	achievement
phone case	achievement
game	achievement
deals	achievement
lot money	achievement
shirt	achievement
brand pair	achievement
mobile	achievement
work shoes	achievement
band	achievement
desk	achievement
home	achievement
position	achievement
book	achievement
role	achievement
brand	achievement
cellphone	achievement
laptop	achievement
lots	achievement
cd	achievement
state	achievement
guitar	achievement
season	achievement
results	achievement
refrigerator	achievement
bicycle	achievement
dream job	achievement
outfit	achievement
haircut	achievement
battery	achievement
case	achievement
thing	achievement
pay	achievement
bike	achievement
work day	achievement
promotion	achievement
paycheck	achievement
performance	achievement
volunteer work	achievement
home job	achievement
sale	achievement
lottery ticket	achievement
paying job	achievement
couple weeks	achievement
work week	achievement
games	achievement
marks	achievement
college	achievement
books	achievement
tickets	achievement
price	achievement
foods	achievement
business	achievement
amount	achievement
technology	achievement
nursing	achievement
flooring	achievement
job opportunity	achievement
tomato	achievement
city	achievement
medication	achievement
bras	achievement
luggage	achievement
words	achievement
time job	achievement
ways	achievement
curtains	achievement
earphones	achievement
chairs	achievement
features	achievement
cycle	achievement
flowers	achievement
job title	achievement
anxiety	achievement
employees	achievement
records	achievement
carpet	achievement
socks	achievement
students	achievement
brakes	achievement
skill	achievement
cars	achievement
government job	achievement
work trip	achievement
responsibilities	achievement
underwear	achievement
grocery store	achievement
pants	achievement
graphics card	achievement
side job	achievement
round	achievement
computer chair	achievement
bonus	achievement
watch band	achievement
bills	achievement
fitness goal	achievement
lawnmower	achievement
life	achievement
desktop computer	achievement
person	achievement
television	achievement
area	achievement
air conditioner	achievement
morning	achievement
work ethic	achievement
app	achievement
sofa	achievement
office chair	achievement
bank account	achievement
hat	achievement
roof	achievement
dress	achievement
apple phone	achievement
apartment	achievement
handbag	achievement
chicken recipe	achievement
chapter	achievement
quarter	achievement
evening	achievement
diet	achievement
washer	achievement
manager	achievement
tool	achievement
meal	achievement
employee	achievement
pillow	achievement
weight	achievement
channel	achievement
fish	achievement
truck	achievement
type	achievement
suit	achievement
bag	achievement
car loan	achievement
look	achievement
mouse	achievement
hits	achievement
room	achievement
career	achievement
dishwasher	achievement
office	achievement
pet	achievement
job promotion	achievement
order	achievement
restaurant	achievement
income	achievement
video	achievement
fragrance	achievement
mail	achievement
work place	achievement
mattress	achievement
event	achievement
couch	achievement
dish	achievement
experience	achievement
piece	achievement
meeting	achievement
college classes	achievement
style	achievement
basketball team	achievement
pounds	achievement
grocery shopping	achievement
car parts	achievement
dinner	achievement
football team	achievement
step	achievement
running time	achievement
boss	achievement
raise	achievement
work bonus	achievement
school year	achievement
work project	achievement
dream car	achievement
dollars	achievement
team	achievement
phone interview	achievement
feedback	achievement
groceries	achievement
prize money	achievement
final	achievement
day job	achievement
while	achievement
responsibility	achievement
freelance work	achievement
law	achievement
work location	achievement
laptop computer	achievement
issues	achievement
feeling	achievement
test	achievement
cards	achievement
payment	achievement
credit card debt	achievement
drink	achievement
couple	achievement
time position	achievement
semester	achievement
work schedule	achievement
work performance	achievement
weight loss	achievement
problems	achievement
performance review	achievement
report	achievement
sports team	achievement
review	achievement
time project	achievement
deal	achievement
bonuses	achievement
credit	achievement
exam	achievement
hour	achievement
fall	achievement
month salary	achievement
soccer team	achievement
couple months	achievement
video card	achievement
chunk	achievement
coffee machine	achievement
pc game	achievement
interview	achievement
tv programs	achievement
checking account	achievement
college days	achievement
game system	achievement
programming language	achievement
computer game	achievement
try	achievement
job applications	achievement
headset	achievement
milestone	achievement
puppy	achievement
hobby	achievement
garden plot	achievement
project file	achievement
level	achievement
goal	achievement
joy	achievement
computer monitor	achievement
dog	achievement
movie	achievement
tablet	achievement
store	achievement
lawn mower	achievement
lease	achievement
source	achievement
stereo	achievement
coat	achievement
ipad	achievement
sofa set	achievement
dining room table	achievement
laser engraving machine	achievement
pc	achievement
camper trailer	achievement
opportunity	achievement
town	achievement
rug	achievement
qualification	achievement
tattoo	achievement
brand apartment	achievement
coffee maker	achievement
software	achievement
appointment	achievement
work clothes	achievement
computer mouse	achievement
bullet	achievement
energy	achievement
drive	achievement
happiness	achievement
task	achievement
line	achievement
knitting pattern	achievement
artist	achievement
updates	achievement
toy	achievement
effort	achievement
compliments	achievement
kitchen table	achievement
dresses	achievement
hair color	achievement
month shift	achievement
gun	achievement
progress	achievement
moments	achievement
ac	achievement
sound system	achievement
employer	achievement
vacuum cleaner	achievement
department	achievement
gaming keyboard	achievement
duplex	achievement
memories	achievement
haircut style	achievement
story	achievement
goals	achievement
grill	achievement
cash	achievement
studio	achievement
house	achievement
weight loss goal	achievement
bottle	achievement
assignment	achievement
pasta recipe	achievement
vacuum	achievement
mob	achievement
car wash	achievement
times	achievement
man	achievement
monitor	achievement
guitar amplifier	achievement
sweater	achievement
brand truck	achievement
feature	achievement
surprise	achievement
grade	achievement
sweatshirt	achievement
blog	achievement
ranking	achievement
instrument	achievement
furnace	achievement
switch	achievement
profit	achievement
work contacts	achievement
minutes	achievement
goal weight	achievement
responses	achievement
couple years	achievement
table	achievement
scratch	achievement
fridge	achievement
headphones	achievement
show	achievement
clothing	achievement
apple watch	achievement
plan	achievement
playstation	achievement
work boots	achievement
ps4	achievement
notes	achievement
timing	achievement
scooter	achievement
classes	achievement
lunch time	achievement
golf putter	achievement
contract	achievement
kind	achievement
houses	achievement
vacation time	achievement
shape	achievement
opening day	achievement
employ	achievement
tasks	achievement
salary increment	achievement
quality	achievement
use	achievement
one	achievement
response	achievement
batch	achievement
tips	achievement
getting call	achievement
thinking	achievement
reviews	achievement
used car	achievement
teacher	achievement
condition	achievement
group project	achievement
bathroom	achievement
products	achievement
email	achievement
location	achievement
contacts	achievement
sheets	achievement
bonus payment	achievement
treatments	achievement
jeans	achievement
growth	achievement
environment	achievement
colors	achievement
ice cream	achievement
stuff	achievement
gold	achievement
salary	achievement
help	achievement
shorts	achievement
locality	achievement
roofing	achievement
jewels	achievement
money order	achievement
shipping	achievement
headset games	achievement
game releases	achievement
couple days	achievement
work task	achievement
work projects	achievement
computer monitors	achievement
work target	achievement
seed	achievement
car tires	achievement
design	achievement
motorcycle	achievement
names	achievement
shoots	achievement
magic	achievement
space	achievement
songs	achievement
wheels	achievement
roommates	achievement
spending money	achievement
episodes	achievement
players	achievement
sandals	achievement
projects	achievement
month week end	achievement
craft project	achievement
tile	achievement
yesterday	achievement
bit	achievement
hardware	achievement
trainees	achievement
gadgets	achievement
tech	achievement
quality clothing	achievement
found space	achievement
work goal	achievement
marathon	achievement
time	affection
moment	affection
night	affection
spending time	affection
days	affection
year	affection
family members	affection
week	affection
weekend	affection
birthday	affection
evening	affection
family friends	affection
day	affection
years	affection
dogs	affection
son	affection
months	affection
family	affection
sister	affection
clothes	affection
work	affection
tears	affection
yard work	affection
day care	affection
home dinner	affection
dog	affection
people	affection
kids	affection
words	affection
school	affection
life	affection
dinner	affection
morning	affection
place	affection
family time	affection
parents	affection
wife	affection
month	affection
sons birthday	affection
husband	affection
thing	affection
baby	affection
children	affection
food	affection
home mom	affection
daughter	affection
weeks	affection
sons school	affection
brother	affection
grades	affection
restaurant	affection
video game	affection
things	affection
car	affection
home pizza	affection
home	affection
quality time	affection
shoes	affection
family photos	affection
cousin brother	affection
hours	affection
summer	affection
movies	affection
baby son	affection
baby daughter	affection
part time work	affection
friends	affection
family trip	affection
daughters birthday	affection
phone	affection
games	affection
bed time	affection
times	affection
girlfriends family	affection
child	affection
birthday gift	affection
lunch time	affection
family party	affection
gifts	affection
sons teacher	affection
surprise birthday party	affection
hugs	affection
joy	affection
walk	affection
toddler son	affection
sons father	affection
recipe	affection
places	affection
wedding	affection
pair	affection
couple days	affection
girl	affection
meal	affection
job	affection
adult daughter	affection
family reunion	affection
foods	affection
dinner date	affection
conversation	affection
birth day	affection
dinner table	affection
sisters daughter	affection
lot	affection
vacation	affection
brothers birthday	affection
puppy	affection
pictures	affection
mother	affection
brothers house	affection
sisters house	affection
school year	affection
medication	affection
bed	affection
girls	affection
event	affection
loved ones	affection
date	affection
parents house	affection
city	affection
night time	affection
report	affection
shirt	affection
family dinner	affection
tablet	affection
ex - husband	affection
moments	affection
mood	affection
trip	affection
money	affection
dresses	affection
fun time	affection
memories	affection
sight	affection
home flowers	affection
step son	affection
ice cream	affection
dads birthday	affection
sisters family	affection
family member	affection
spring day	affection
moms birthday	affection
time girlfriend	affection
girlfriend	affection
steak dinner	affection
summer vacation	affection
infant daughter	affection
steps	affection
cousin	affection
regulars	affection
chat	affection
flowers	affection
sisters	affection
grocery shopping	affection
family vacation	affection
sisters birthday	affection
side	affection
work trip	affection
nephew	affection
marks	affection
home cooked meal	affection
puppies	affection
surprise	affection
fathers birthday	affection
mom	affection
job offer	affection
part	affection
date night	affection
vacation time	affection
surprise party	affection
party	affection
toy	affection
cat	affection
family pictures	affection
ex - girlfriend	affection
breakfast	affection
childhood days	affection
drive	affection
end day	affection
kitten	affection
story time	affection
daughters teacher	affection
family members birthday	affection
family events	affection
mommy	affection
work day	affection
dinner party	affection
book	affection
dish	affection
tickets	affection
watch	affection
baby niece	affection
brother marriage	affection
family tour	affection
bonding time	affection
boy	affection
lunch	affection
daughters birthday party	affection
daughters school	affection
water	affection
brothers family	affection
bit	affection
movie	affection
town	affection
family meals	affection
life time	affection
college days	affection
minutes	affection
boyfriends family	affection
members	affection
videos	affection
home run	affection
family wedding	affection
cousin sister	affection
while	affection
school work	affection
boy friend	affection
couple weeks	affection
distance boyfriend	affection
babies	affection
care	affection
happiness	affection
girl friend	affection
school bag	affection
opening day	affection
teeth	affection
month daughter	affection
marriage	affection
parents wedding day	affection
tricks	affection
husbands birthday	affection
field trip	affection
family picnic	affection
face	affection
infant son	affection
adult son	affection
life partner	affection
birth	affection
brother birthday	affection
baby dog	affection
daughters class	affection
birthday dinner	affection
meals	affection
weather	affection
books	affection
relation	affection
sons party	affection
laugh	affection
outfits	affection
cats	affection
game	affection
nursing	affection
way	affection
surgery	affection
birthday card	affection
girlfriends house	affection
family day	affection
girlfriends	affection
run	affection
bike	affection
quarter	affection
state	affection
experience	affection
cards	affection
gap	affection
minute	affection
wedding anniversary	affection
jobs	affection
day week	affection
surprise gift	affection
tee ball game	affection
park	affection
school event	affection
husbands family	affection
morning text	affection
daughters friends	affection
cell phone	affection
summer holidays	affection
nieces birthday	affection
couple	affection
deal	affection
dress	affection
guy	affection
pet	affection
baby nephew	affection
mothers house	affection
chocolate	affection
ex girlfriend	affection
kid	affection
mothers birthday	affection
conversations	affection
distance girlfriend	affection
neighbors daughter	affection
business	affection
house	affection
apartment	affection
class	affection
person	affection
egg	affection
couch	affection
watch movie	affection
purse	affection
hand	affection
business trip	affection
smiles	affection
cake	affection
anniversary dinner	affection
songs	affection
couple hours	affection
houses	affection
born son	affection
weekend trip	affection
bicycle	affection
moods	affection
shopping	affection
sons room	affection
amusement	affection
heart	affection
nights	affection
truck	affection
niece	affection
baby girl	affection
day weekend	affection
coffee	affection
anniversary	affection
man	affection
thoughts	affection
ex - wife	affection
balance	affection
love	affection
song	affection
camera	affection
yesterday	affection
granddaughter	affection
family game night	affection
distance relationship	affection
job interview	affection
cars	affection
junk food	affection
brothers son	affection
feel	affection
smartphone	affection
card	affection
daughters party	affection
gift	affection
mom food	affection
boyfriends mother	affection
results	affection
surprises	affection
concert tickets	affection
sons baseball team	affection
ex - boyfriend	affection
spirits	affection
laws	affection
sons birthday cake	affection
kiss	affection
sons band concert	affection
nap	affection
surprise dinner	affection
pet dog	affection
sister birthday	affection
ex husband	affection
tooth	affection
home town	affection
year niece	affection
school play	affection
vacation home	affection
parents dog	affection
road trip	affection
baseball	affection
home state	affection
walks	affection
sons friends	affection
project	affection
period	affection
movie night	affection
sons graduation	affection
talk	affection
neighbors son	affection
boyfriends house	affection
weekends	affection
cousins	affection
faces	affection
family gathering	affection
daughter school	affection
birthday messages	affection
nieces birthday party	affection
daughters face	affection
nephews birthday	affection
sisters wedding	affection
time job	affection
month 3rd	affection
change	affection
ex boyfriend	affection
sister marriage	affection
brothers wedding	affection
break	affection
days work	affection
mom house	affection
fight	affection
born baby	affection
life events	affection
birthday party	affection
prize	affection
feelings	affection
friends dog	affection
family life	affection
boyfriend	affection
pizza dinner	affection
cousins birthday	affection
mother heart operation	affection
made pancakes breakfast	affection
baby cousin	affection
drinks	affection
music	affection
sons dinner	affection
feeling	affection
spending	affection
girlfriends birthday	affection
part time job	affection
family lunch	affection
eggs	affection
birds	affection
graduation	affection
family meal	affection
year son	affection
playing	affection
fun	affection
emotions	affection
moms house	affection
day dinner	affection
pizza	affection
freshman year	affection
kids going	affection
baby chicks	affection
time sex	affection
dessert	affection
lunch date	affection
tv show	affection
grade	affection
learning	affection
occasion	affection
mother birthday event	affection
time sister	affection
parents wedding anniversary	affection
birthday occasion	affection
hearing	affection
fist time	affection
sign	affection
sister husband	affection
having time	affection
hair	affection
baby birds	affection
smile	affection
sons	affection
brothers daughter	affection
movie theater	affection
daughters	affection
home time	affection
cousin house	affection
sons baseball game	affection
shower	affection
sisters son	affection
home dessert	affection
report card	affection
neighbors	affection
school fellows	affection
work time	affection
boyfriends birthday	affection
vinyl art making	affection
spa day	affection
plane tickets	affection
school family	affection
periods	affection
soccer game	affection
cousins birthday party	affection
college	affection
relief	affection
baby boy	affection
mother daughter trip	affection
middle night	affection
week trip	affection
friend	affection
girlfriends cat	affection
visiting family	affection
surprise birthday gift	affection
today	affection
daughters tooth	affection
dance	affection
couple months	affection
resent moment	affection
date night surprise	affection
movie time	affection
sisters puppy	affection
mothers day gift	affection
mothers face	affection
obedience	affection
chocolate cake	affection
sons report card	affection
families life	affection
birthday celebration	affection
spring weather	nature
weather	nature
day	nature
month weather change	nature
weather emergencies	nature
sleeping weather	nature
weather situations	nature
flowers	nature
days	nature
birds	nature
gardens	nature
weather day	nature
spring today	nature
morning rain	nature
nature	nature
sky day	nature
mountains	nature
weekend	nature
week spring	nature
rain	nature
rose flower plant	nature
sunlight	nature
time	nature
rain storms	nature
homes	nature
rain water	nature
rain season	nature
night	nature
walk	nature
rain drops	nature
day week	nature
week	nature
blooming flowers	nature
spring day	nature
feel	nature
watching rain	nature
sun	nature
month	nature
morning walk	nature
weather temperature	nature
roses flowers	nature
walk weather	nature
spring flowers	nature
sun conure bird	nature
year	nature
weather forecast	nature
blazing weather	nature
evenings	nature
morning	nature
afternoon	nature
degree weather	nature
rose plant	nature
plants	nature
mornings	nature
rain shower	nature
spring air	nature
weather report	nature
evening	nature
rise	nature
flowers blooming	nature
garden	nature
summer	nature
climes	nature
flower pots	nature
spring night rain	nature
fall	nature
work week	nature
raining days	nature
lunch time	nature
blooming plants	nature
bird feeders	nature
approaching day	nature
vegetable plants	nature
shower	nature
blocking	nature
hours	nature
riding weather	nature
plant shopping	nature
yard work	nature
spring	nature
spring time bike ride	nature
bike ride	nature
hour	nature
hike	nature
snow day	nature
birds chirp	nature
bird	nature
baby birds	nature
couple days	nature
mountain hike	nature
trees	nature
degree day	nature
hiking	nature
hanging plants	nature
days summer	nature
rainy day	nature
day end	nature
day spring	nature
sunset	nature
air condition	nature
mornings weather	nature
park	nature
spring sunshine	nature
snow	nature
bike rides	nature
trail	nature
areas weather	nature
house	nature
month night	nature
rose	nature
lightning storm	nature
spring vegetable garden	nature
lunch break	nature
bunny	nature
breeze	nature
sunshine	nature
air	nature
days season	nature
thunderstorm	nature
weeks	nature
months	nature
periods	nature
goldfinch	nature
area	nature
work	nature
neighborhood	nature
couple	nature
lake	nature
rain storm	nature
skies	nature
rainbow	nature
sound	nature
view	nature
run	nature
deer	nature
perfect morning air	nature
nature walk	nature
rain coat	nature
barred owl	nature
drive	nature
week weather	nature
sights	nature
relief	nature
sunrise	nature
neighborhood trail	nature
mood	nature
waterfall	nature
egret	nature
look	nature
eagle	nature
day streak	nature
blanket	nature
photograph	nature
experience	nature
crocus	nature
fragrance	nature
needed rain	nature
downpour	nature
cappuccino	nature
bouquet	nature
showers tree	nature
winds	nature
soaking rain	nature
way birds	nature
morning light	nature
wind	nature
summer week	nature
morning air	nature
slow breeze	nature
rain gear	nature
nature beauty	nature
thing	nature
moment	nature
place	nature
animals	nature
window thing	nature
hiking trails	nature
vegetable garden	nature
feeling	nature
km walk	nature
lunchtime walk	nature
miles	nature
mountains thing	nature
windows	nature
nature lovers	nature
person	nature
air pollutants	nature
air conditioning	nature
rose garden	nature
temperatures	nature
sky	nature
day season	nature
spring season	nature
lunch hour	nature
mile walk	nature
beginning	nature
approaching day year	nature
flower vegetable garden	nature
garden plant tomatoes	nature
garden bloom	nature
prices	nature
dogs	nature
knowing winter	nature
flower seeds	nature
snow boarding	nature
forest animals	nature
springs	nature
lots	nature
flower buds	nature
azalea bloom	nature
coming spring	nature
fallen rose petals	nature
balcony garden	nature
timing	nature
sun rays	nature
mountain trails	nature
veggie garden	nature
cacti garden	nature
nature park	nature
rays	nature
bit	nature
sun setting	nature
hour half	nature
roof garden	nature
bird dive	nature
bloom	nature
flower beds	nature
wind day	nature
vegetables	nature
storm	nature
city	nature
center	nature
inches	nature
garden bloomed	nature
event	nature
degrees	nature
flower	nature
humming bird feeder	nature
tulip bloom	nature
smell	nature
backyard	nature
sunflowers	nature
trails	nature
winter	nature
day weekend	nature
frogs	nature
leaves	nature
day degrees	nature
people	nature
tomato plants	nature
red	nature
dogwoods	nature
bird nest	nature
roses	nature
mint plants	nature
lime plant	nature
blueberry plants	nature
okra plant	nature
spot	nature
thunder storm	nature
fruit	nature
years	nature
corpse plant	nature
parking spot	nature
jasmine plant	nature
nature trail	nature
jalapeno plant	nature
yesterday	nature
mother bird	nature
watched city	nature
areas	nature
tree	nature
dog	nature
way	nature
bird feeder	nature
sapling	nature
hummingbird	nature
sign	nature
lava	nature
taste	nature
mint	nature
plantings	nature
sprouts	nature
herbs	nature
farmers markets	nature
bear	nature
cookout	nature
bicycle ride	nature
coffee	nature
cycling ride	nature
middle day	nature
types	nature
ore roses	nature
neon tree	nature
summer seasons	nature
baby maple tree	nature
working week	nature
tasks	nature
weekends	nature
spring breeze	nature
hiking trail	nature
magnolia tree	nature
watching raindrops race	nature
vacation trip	nature
water	nature
list trip	nature
veggies	nature
movement	nature
state park	nature
list	nature
backyard garden bed	nature
things	nature
mountain	nature
trip	nature
soil	nature
maple tree	nature
mountain trail	nature
bike	nature
thunderstorms	nature
song	nature
tree branches	nature
stretch	nature
papaya tree	nature
home	nature
surfing trip	nature
peach tree	nature
toads	nature
persimmon tree	nature
storms	nature
trips	nature
capacity	nature
spring summer seasons	nature
time year	nature
lemon tree	nature
schools	nature
force	nature
nights	nature
pepper tomato plants	nature
forecasted thunderstorms	nature
type	nature
hours afternoon	nature
okra	nature
water scarcity	nature
varieties	nature
mountain bike	nature
friends	nature
mountain biking trip	nature
snow storm	nature
seed	nature
air show	nature
nature trailer	nature
walking path	nature
riverside trail	nature
season weeks	nature
parks	nature
nature reserve	nature
back yard	nature
seed containers	nature
yard	nature
half hour hike	nature
air pollution event	nature
temperature	nature
deserved awaited camping	nature
grass	nature
ride	nature
doors	nature
blooms	nature
computer work	nature
work pressure	nature
works building	nature
minutes	nature
seasons	nature
bedroom window	nature
fools snow event	nature
porch	nature
office window	nature
break	nature
raindrops	nature
forests	nature
beginning spring	nature
nature preserve	nature
middle spring	nature
places	nature
train yard	nature
nature program	nature
wilderness	nature
front	nature
glory	nature
traffic	nature
mind people	nature
summer holiday	nature
amusement	nature
honeysuckle blooming	nature
birding park	nature
situation	nature
lunch	nature
station	nature
rainbows	nature
snow plow truck	nature
book	nature
climate	nature
afternoon class	nature
animal	nature
breakfast	nature
weekend camping	nature
beer	nature
history	nature
determination	nature
rising temperature	nature
neighbors cherry tree	nature
snow blizzard	nature
got air	nature
start	nature
deal	nature
salry hike	nature
stages	nature
mountain peak	nature
office tour	nature
forsythia blooming	nature
pepper seeds	nature
walking trail	nature
hour hike	nature
outfit	nature
apartment	nature
hills	nature
hay fever symptoms	nature
lot difference	nature
clouds	nature
hiking trip	nature
camping ground	nature
coffee shop	nature
office	nature
rose bushes	nature
seeds	nature
colors	nature
items	nature
poking	nature
growth	nature
animals elephant	nature
camping	nature
grosbeak	nature
grass seed	nature
families	nature
falls	nature
love interest	nature
cup	nature
spring year	nature
year afternoon	nature
antidote	nature
rosebush	nature
rifle falls	nature
mile hike	nature
spring greens	nature
plant consciousness event	nature
ducks	nature
wildflowers	nature
town	nature
group	nature
fruits	nature
magazine	nature
hobby	nature
growth activity	nature
happiness	nature
works	nature
natures happiness	nature
couple miles	nature
ears	nature
events	nature
bloomed tulips	nature
gardening season	nature
gratitude	nature
lightning strikes	nature
ones	nature
outing	nature
life	nature
dirt bike	nature
home system	nature
nature preserve ad	nature
friends dog	nature
chores	nature
swam	nature
thunder	nature
bud	nature
storm system	nature
camping area	nature
jungle trip	nature
stone	nature
pictures	nature
grocery shopping	nature
weeds	nature
food	nature
car	nature
state	nature
swimming	nature
couple weekends	nature
baby ducklings	nature
airport park	nature
earth	nature
development	nature
species	nature
video games	leisure
game	leisure
games	leisure
songs	leisure
music	leisure
video game	leisure
night	leisure
strings	leisure
videos	leisure
weekend	leisure
video game overwatch	leisure
month	leisure
movie	leisure
evening	leisure
anime shows	leisure
star wars movie	leisure
time	leisure
show	leisure
baseball game	leisure
video	leisure
tv series	leisure
tv	leisure
episodes	leisure
baseball team	leisure
hockey game	leisure
movie playing game	leisure
tv show	leisure
watched lantern	leisure
television series	leisure
team	leisure
hockey team	leisure
played video games	leisure
duty video game	leisure
video game lovers	leisure
sports team	leisure
baseball player	leisure
seasons title game	leisure
series	leisure
television program	leisure
restaurant	leisure
ice cream	leisure
playing video	leisure
food	leisure
season	leisure
week	leisure
board game	leisure
beer	leisure
podcast	leisure
band	leisure
opening day game	leisure
player	leisure
film	leisure
finished game	leisure
twitch streamers	leisure
anime	leisure
videogame	leisure
guardians	leisure
type	leisure
streamer	leisure
comedian	leisure
soap opera	leisure
snacks	leisure
episode	leisure
performers	leisure
novel	leisure
brewery	leisure
destinations	leisure
album	leisure
movie teaser	leisure
watched heros	leisure
books	leisure
power rangers	leisure
morning	leisure
hobby	leisure
basketball	leisure
reality show	leisure
playoff	leisure
school games	leisure
seasons	leisure
day	leisure
multiplayer games	leisure
raider game	leisure
television show	leisure
game series	leisure
comedy show	leisure
guitars	leisure
day show	leisure
movie guardians	leisure
photos	leisure
dresses	leisure
video game stream	leisure
tunes	leisure
movies	leisure
name country	leisure
brand video game	leisure
video game system	leisure
video game charger	leisure
author	leisure
concert tickets	leisure
brand chapters	leisure
hours	leisure
clothes	leisure
friends	leisure
videogames	leisure
prison break	leisure
tops	leisure
watch	leisure
craft supplies	leisure
tidbits	leisure
content	leisure
products	leisure
sneakers	leisure
tv game show	leisure
childhood games	leisure
mobile game	leisure
console game	leisure
comedy movie	leisure
shows	leisure
weeks	leisure
online game	leisure
store	leisure
game play	leisure
food shopping	leisure
game console	leisure
movie ticket	leisure
vide game	leisure
game developer	leisure
movie theaters	leisure
book	leisure
tv episode	leisure
brand tv show	leisure
cooking shows	leisure
music shows	leisure
comedy videos	leisure
movie trailers	leisure
reality tv show	leisure
video game series	leisure
call	leisure
porn movies	leisure
tickets	leisure
movie game	leisure
couple episodes	leisure
tv show storage wars	leisure
television game	leisure
song	leisure
star wars video game	leisure
night tv	leisure
game show network	leisure
video game console	leisure
multiplayer video game	leisure
years week	leisure
passengers movie	leisure
video poker	leisure
watched	leisure
game show	leisure
movie beauty	leisure
video game store	leisure
computer video game	leisure
video game solo	leisure
home game	leisure
video game convention	leisure
saw guardians	leisure
writers	leisure
trip	leisure
tv episodes	leisure
nap	leisure
year	leisure
opening day baseball games	leisure
movie series	leisure
dinner	leisure
book series	leisure
television shows	leisure
getting woken	leisure
fail videos	leisure
anime show	leisure
comedy shows	leisure
concert	leisure
childhood movie	leisure
video games sequels	leisure
fire tv	leisure
light	leisure
aliens movie	leisure
reality shows	leisure
talk show	leisure
news show	leisure
show survivor	leisure
wonder woman movie	leisure
youtubers videos	leisure
vacation time	leisure
chess games	leisure
music video	leisure
movie actor	leisure
childhood movies	leisure
work	leisure
league baseball game	leisure
game winning base	leisure
opening day	leisure
thriller movie	leisure
minute	leisure
fun games	leisure
television	leisure
grocery shopping	leisure
couple days	leisure
year dos	leisure
league game	leisure
basketball games	leisure
x movie	leisure
blade runner movie	leisure
championship game	leisure
college basketball game	leisure
pc multiplayer game	leisure
game store	leisure
gods show	leisure
season opening episode	leisure
game tournament	leisure
college basketball championship game	leisure
basketball game	leisure
playoff game	leisure
school episode	leisure
amount	leisure
deal	leisure
prison break episode	leisure
vacation trip	leisure
black	leisure
playoff basketball game	leisure
vacation days	leisure
game consoles	leisure
tv dinner	leisure
tv programs	leisure
fun game	leisure
arcade game	leisure
card game	leisure
computer game	leisure
soccer game	leisure
nap time	leisure
movie show theatre	leisure
fps game	leisure
past times	leisure
shopping	leisure
basketball team	leisure
multiplayer game	leisure
wings hockey game	leisure
tennis game	leisure
podcasts brand episode	leisure
role playing games	leisure
baseball season	leisure
days	leisure
couple games	leisure
childhood game	leisure
football games	leisure
warriors playoff game	leisure
playoff hockey game	leisure
spring game	leisure
switch game	leisure
augmented reality game	leisure
overwatch comp game	leisure
game rental company	leisure
walking episode	leisure
opening day baseball game	leisure
server game	leisure
blizzard game	leisure
rap game	leisure
game programming engine	leisure
hole golf game	leisure
marathon game	leisure
softball game	leisure
game codes	leisure
monopoly game	leisure
bulls game	leisure
game compilation	leisure
baseball opening day	leisure
soccer teams	leisure
blazers game	leisure
team playing	leisure
cricket team	leisure
memories	leisure
weeks episode	leisure
tv program	leisure
hometown team win	leisure
home	leisure
opening	leisure
game way	leisure
walking game	leisure
go game	leisure
husbands team	leisure
tag teams	leisure
game streamer	leisure
game enemy	leisure
teams	leisure
lacrosse team	leisure
n.b.a team	leisure
shield episode	leisure
role playing game	leisure
warriors game	leisure
sports game	leisure
drinking game	leisure
basket ball game	leisure
dungeon crawler game	leisure
game gift	leisure
overtime game	leisure
heros movie	leisure
reviews	leisure
peaks series	leisure
poker game	leisure
penguins game	leisure
d&d game	leisure
game expansion	leisure
tv series season	leisure
reality batman game	leisure
hour night	leisure
times	leisure
baseball moments	leisure
music artist	leisure
music channel	leisure
music group	leisure
anime season	leisure
brand book	leisure
whiskys	leisure
colleges quidditch game	leisure
shopping mall	leisure
basketball teams	leisure
season premiere	leisure
game show network esque channel	leisure
chefs	leisure
hangout	leisure
drama series	leisure
vacation	leisure
season premier	leisure
wrestling show	leisure
fun vacation	leisure
cartoon series	leisure
years	leisure
break time	leisure
walking tv show	leisure
beer trivia night	leisure
album song	leisure
league team	leisure
ice cream cone	leisure
beach	leisure
leisure time	leisure
band preform	leisure
feel movie	leisure
place	leisure
rock band	leisure
discount prices	leisure
play	leisure
coffee shop	leisure
park	leisure
peaks	leisure
couples	leisure
podcast channel	leisure
covenant film	leisure
walk	leisure
comedy podcasts	leisure
musicians concert	leisure
lunch places	leisure
college player	leisure
music album	leisure
couple hours	leisure
day week	leisure
tv shows	leisure
cities	leisure
sports anime	leisure
brand computer	leisure
comedy series	leisure
ride	leisure
donut shop	leisure
artist	leisure
way	leisure
nights stream	leisure
channel	leisure
cooking recipe	leisure
street fighter player	leisure
jack	leisure
bands	leisure
fishing spot	leisure
meal	leisure
wine	leisure
music venue	leisure
brand	leisure
opera singer	leisure
kind	leisure
rank	leisure
actors	leisure
pizza	leisure
update	leisure
mass effect	leisure
nephews baseball game	leisure
burger	leisure
thrones season	leisure
hearthstone stream	leisure
hip hop artist	leisure
set	leisure
pizza places	leisure
dish	leisure
dress	leisure
characters	leisure
recipe	leisure
singers	leisure
bow hunters	leisure
wrestlers	leisure
countries	leisure
vanity issue	leisure
festival	leisure
trail	leisure
shelving system	leisure
travel destinations	leisure
spot	leisure
bathing suit	leisure
hamburger	leisure
controller	leisure
version	leisure
techniques	leisure
produce market	leisure
drinks	leisure
village	leisure
top	leisure
tale	leisure
save	leisure
producer	leisure
comic	leisure
musician	leisure
cookies	leisure
stuff	leisure
streamer broadcast	leisure
blog	leisure
creamer	leisure
golfers	leisure
conspiracy theories	leisure
errand	leisure
rollerblades	leisure
medication	leisure
planet	leisure
kdrama	leisure
city	leisure
couple weeks	leisure
flavor	leisure
entertainers	leisure
bachelorette	leisure
attack mode	leisure
youtube channels	leisure
sports	leisure
poem	leisure
classics	leisure
djs	leisure
brew	leisure
cuisines	leisure
bartender	leisure
horror movies	leisure
suspense movie	leisure
gamer	leisure
chicken dish	leisure
months	leisure
star	leisure
actors movie	leisure
twitch streamer	leisure
youtube vloggers	leisure
bubble bath	leisure
potato chips	leisure
pizza restaurant	leisure
brand comedy	leisure
sandwich	leisure
moments	leisure
uploader	leisure
resturant	leisure
nitrogen ice cream	leisure
fun mode	leisure
taco stand	leisure
character	leisure
artists	leisure
actor	leisure
apps	leisure
playlist	leisure
stars	leisure
crawfish restaurant	leisure
mangas	leisure
comics	leisure
sushi	leisure
youtuber	leisure
sit	leisure
biriyani	leisure
beverage	leisure
youtubers	leisure
rappers	leisure
director	leisure
go	leisure
martian	leisure
fruit	leisure
era	leisure
bbq place	leisure
switch system	leisure
coffee creamer option	leisure
stars movie	leisure
level	leisure
tears	leisure
season opening game	leisure
cable box	leisure
season champion	leisure
card	leisure
game winning streak	leisure
friends	bonding
school friends	bonding
friend	bonding
friend marriage	bonding
childhood friends	bonding
college friends	bonding
office friends	bonding
friends birthday party	bonding
friends wedding	bonding
couple friends	bonding
people	bonding
friend birthday	bonding
memories	bonding
coworkers	bonding
lost friend	bonding
time	bonding
childhood friend	bonding
friends birthday	bonding
days	bonding
friends night	bonding
friends house	bonding
day	bonding
lady friend	bonding
friend name	bonding
friend study	bonding
gentleman friend	bonding
friends dog	bonding
friend move	bonding
collage friends	bonding
government job friends meeting friends	bonding
friends going	bonding
friends party	bonding
times	bonding
year	bonding
friend marriage function	bonding
friends mother	bonding
friends weddings	bonding
friends thing	bonding
girl friend	bonding
friends baby	bonding
office friend	bonding
time friend	bonding
work friends	bonding
time friends	bonding
family friends	bonding
week	bonding
night	bonding
state friend	bonding
friends celebration	bonding
friend request	bonding
friend married	bonding
village friends	bonding
dads friends	bonding
protest friends	bonding
friend downtown	bonding
town friend	bonding
weekend	bonding
friends graduation	bonding
birthday celebrations	bonding
conversation	bonding
friends car	bonding
evening	bonding
saw friends	bonding
co - workers	bonding
- friends	bonding
needs friends	bonding
friend surprised	bonding
college friends bike trip	bonding
friends engagement ceremony	bonding
friend marriage reception	bonding
friends place	bonding
sons friend	bonding
friends band	bonding
co - worker	bonding
school friend	bonding
friend engagement function	bonding
college friend	bonding
lunch time	bonding
video game	bonding
friend got married	bonding
years	bonding
morning	bonding
saw friend	bonding
dinner	bonding
neighbors	bonding
month	bonding
months	bonding
longtime friends	bonding
friend tubing	bonding
school days friends	bonding
distance friend	bonding
clothes	bonding
school time friend	bonding
time friends wedding	bonding
age school friend	bonding
school childhood friend	bonding
company friends	bonding
boy friend	bonding
friends website	bonding
time boy friend	bonding
time internet friend	bonding
friends business	bonding
restaurant	bonding
friends wedding day	bonding
games	bonding
friends birthday event	bonding
school day friend	bonding
life friend	bonding
school girl friend	bonding
school friend marriage	bonding
childhood school friend	bonding
lost friends	bonding
friends games	bonding
colleague friend	bonding
friend birthday date	bonding
lot friends	bonding
friends birthday celebration	bonding
class time friend	bonding
internet friend	bonding
group friends	bonding
distance friends	bonding
friends wedding anniversaries	bonding
boyfriends friends house	bonding
co - friend	bonding
childhood days	bonding
family friend	bonding
guy friends	bonding
child hood friend	bonding
game friends	bonding
friends husband	bonding
neighborhood friends	bonding
friend record	bonding
friends farm	bonding
friend practice	bonding
meet friends	bonding
musician friend	bonding
programmer friend	bonding
fb friends	bonding
gardener friend	bonding
friends family members	bonding
college friend marriage function	bonding
office friend home function	bonding
work friend	bonding
birthday	bonding
ex girl friend	bonding
dog friends	bonding
friend marriage party.i	bonding
puppy	bonding
friend visit	bonding
business friend	bonding
daughters friend	bonding
moms friend	bonding
friends sister	bonding
friends paper	bonding
internet friends	bonding
dearest friends	bonding
friends horse	bonding
preschool friends	bonding
photographer friend	bonding
colony friend	bonding
author friend	bonding
living friend	bonding
closet friends	bonding
existing friends	bonding
helped friend	bonding
friend stream poker	bonding
friends marriage	bonding
card games	bonding
friends computer	bonding
family friends hair	bonding
friends rabbit	bonding
friend circle	bonding
members friends	bonding
videos	bonding
lunch	bonding
went	bonding
job	bonding
co worker	bonding
hours	bonding
meal	bonding
enjoyment	bonding
opportunity	bonding
school times	bonding
lost childhood friend	bonding
moment	bonding
food	bonding
work colleagues	bonding
feeling	bonding
college roommate	bonding
school	bonding
memory time	bonding
movies	bonding
co - worker friend	bonding
video games	bonding
baseball game	bonding
game	bonding
trivia night	bonding
party	bonding
week going	bonding
neighbor	bonding
friends wedding date	bonding
friends brother marriage	bonding
childhood friends birthday	bonding
friends girlfriend	bonding
friends graduation ceremony	bonding
friends art show	bonding
friends child	bonding
party celebration	bonding
friends son	bonding
friends bachelor party	bonding
friends correct diagnosis	bonding
moments	bonding
friends news	bonding
friends housewarming	bonding
friends mom	bonding
birthday cake	bonding
work	bonding
friends wedding ceremony	bonding
roommate friend	bonding
friends brain cancer	bonding
dinner date	bonding
plans	bonding
friends boyfriend	bonding
neighbor friend	bonding
friends visit	bonding
friends daughter	bonding
fun	bonding
things	bonding
friends project	bonding
friends puppy	bonding
friends pet	bonding
met friend	bonding
spending time	bonding
music	bonding
life time	bonding
weeks	bonding
friends b day	bonding
friends birthday dinner	bonding
gifts	bonding
friends music night	bonding
school friends house	bonding
school college friends	bonding
friends birthday gathering	bonding
tickets	bonding
friends housewarming party	bonding
friends graduation party	bonding
lost school friends	bonding
friends graduation dinner	bonding
man	bonding
school video games	bonding
school friends restaurant	bonding
lady	bonding
advice	bonding
quality	bonding
college	bonding
idea	bonding
student	bonding
movie trailers	bonding
grad school friends engagement	bonding
friends company anniversary	bonding
friends shop	bonding
co worker friend	bonding
sharing	bonding
example	bonding
spirits	bonding
marks	bonding
exercise	bonding
listeners	bonding
month going	bonding
friends wedding reception	bonding
friends wedding party	bonding
life	bonding
friends labrador puppy	bonding
fun time	bonding
childhood friends contact	bonding
friends upcoming birthday	bonding
places	bonding
friends birthday benefit	bonding
experience	bonding
friends baby shower	bonding
friends concert	bonding
classmates	bonding
talk	bonding
friends cat	bonding
friends e - mail	bonding
friends parents house	bonding
childhood friends baby shower	bonding
cash strapped friend	bonding
friends tattoo appointment	bonding
friends kitten	bonding
college friends wedding	bonding
relationship	bonding
plants	bonding
daughters friends birthday party dinner	bonding
marriage	bonding
acquaintance	bonding
friends coworkers	bonding
laughs	bonding
friends year daughter	bonding
friends family problem	bonding
score	bonding
recipes	bonding
citizen retired friend	bonding
pals	bonding
stage	bonding
friends marriage reception	bonding
communication	bonding
visited friend	bonding
speed	bonding
friends goodbye dinner	bonding
friends kid	bonding
friends bridal shower	bonding
friends cats	bonding
friends children	bonding
friends commencement ceremony	bonding
posting friend	bonding
friends barbecue	bonding
friends diagnosis	bonding
friends promotion	bonding
weather	bonding
friends horses	bonding
friends actions	bonding
boyfriends friend	bonding
trips	bonding
friends backyard	bonding
fiances friends	bonding
friends grandmother	bonding
friends recommendation	bonding
surprised friend	bonding
friends circle	bonding
friends celebration party	bonding
going party	bonding
place	bonding
movie	bonding
coworkers friends	bonding
drinks	bonding
stuff	bonding
friends wedding anniversary	bonding
friends fashion show	bonding
friends show	bonding
friends room	bonding
friends daughters school graduation	bonding
friends apartment	bonding
friends engagement	bonding
friends parent	bonding
friends posts	bonding
friends recipe	bonding
fathers friend	bonding
friends voice	bonding
friends headache	bonding
friends parrots	bonding
school music	bonding
trip	bonding
lot	bonding
friends family	bonding
friends kids	bonding
friends interest	bonding
friends piano	bonding
friends guitar	bonding
event	bonding
search plants	bonding
home	bonding
band	bonding
friends baby daughters birthday party	bonding
coffee	bonding
friends wedding spending time	bonding
school boys	bonding
school days	bonding
colleagues	bonding
girl	bonding
office	bonding
students	bonding
birthday dinner	bonding
person	bonding
- mail	bonding
birthday card	bonding
friends made shop	bonding
animal video	bonding
room	bonding
car	bonding
pictures	bonding
money	bonding
town	bonding
childhood	bonding
dinner party	bonding
matters	bonding
discussion	bonding
state	bonding
video	bonding
college days	bonding
minutes	bonding
day game	bonding
apartment	bonding
season	bonding
mates	bonding
stories	bonding
media	bonding
family	bonding
hobby	bonding
haircut	bonding
lost time	bonding
couple days	bonding
age	bonding
episodes	bonding
school days memories	bonding
way	bonding
rounds	bonding
friendships	bonding
story time	bonding
movie theater friends	bonding
family friends wedding	bonding
songs	bonding
take time	bonding
road trip	bonding
couple hours	bonding
vacation	bonding
friends sons	bonding
friend cum - client	bonding
comedy videos	bonding
birthday lunch	bonding
birthday party	bonding
movie night	bonding
colleague	bonding
graduation ceremony	bonding
hotel	bonding
city	bonding
dresses	bonding
vehicles	bonding
understanding friends	bonding
preferences	bonding
wedding	bonding
day life	bonding
coffee time	bonding
phone call	bonding
minute	bonding
license	bonding
candidates	bonding
rider	bonding
boat	bonding
musicals	bonding
school time	bonding
camping trip	bonding
game night	bonding
quality gaming time	bonding
project	bonding
coffee shop	bonding
beers	bonding
day tickets	bonding
week attend	bonding
parties	bonding
contact lenses	bonding
gift card	bonding
drank beer	bonding
movie dvds	bonding
brand pens	bonding
class	bonding
adult friend	bonding
computer skills	bonding
brand laptop	bonding
meet	bonding
basketball game	bonding
worker	bonding
surprise	bonding
restrictions	bonding
while	bonding
board game	bonding
hockey game	bonding
family movie night	bonding
computer	bonding
chat	bonding
friend birthday celebration	bonding
fun night	bonding
marriage function	bonding
chain gifts	bonding
birthday gift	bonding
trip travel	bonding
cycle trip	bonding
brand new	bonding
fun chat	bonding
challenges	bonding
ones	bonding
family members	bonding
horror	bonding
chess game	bonding
bar	bonding
barbecue	bonding
college trip	bonding
night socializing	bonding
period	bonding
girls	bonding
neighbors dog	bonding
pool party	bonding
couple	bonding
cake	bonding
couple years	bonding
bench	bonding
days events	bonding
party event	bonding
events	bonding
day	enjoy_the_moment
night	enjoy_the_moment
days	enjoy_the_moment
people	enjoy_the_moment
moment	enjoy_the_moment
time	enjoy_the_moment
month	enjoy_the_moment
year	enjoy_the_moment
music	enjoy_the_moment
weekend	enjoy_the_moment
week	enjoy_the_moment
lunch	enjoy_the_moment
car	enjoy_the_moment
coffee	enjoy_the_moment
work	enjoy_the_moment
eating chocolate	enjoy_the_moment
morning	enjoy_the_moment
ice cream	enjoy_the_moment
food	enjoy_the_moment
dinner	enjoy_the_moment
work day	enjoy_the_moment
pizza place	enjoy_the_moment
money	enjoy_the_moment
coffee shop	enjoy_the_moment
surprises	enjoy_the_moment
meal	enjoy_the_moment
breakfast	enjoy_the_moment
things	enjoy_the_moment
pizza	enjoy_the_moment
nights	enjoy_the_moment
restaurant	enjoy_the_moment
lunch time	enjoy_the_moment
baseball team	enjoy_the_moment
basketball team	enjoy_the_moment
price	enjoy_the_moment
amount	enjoy_the_moment
team	enjoy_the_moment
deal	enjoy_the_moment
sandwich	enjoy_the_moment
songs	enjoy_the_moment
weeks	enjoy_the_moment
drink	enjoy_the_moment
baseball player	enjoy_the_moment
beer	enjoy_the_moment
flavor	enjoy_the_moment
brand	enjoy_the_moment
cereal	enjoy_the_moment
player	enjoy_the_moment
singer	enjoy_the_moment
nights sleep	enjoy_the_moment
hair day	enjoy_the_moment
sleep	enjoy_the_moment
times	enjoy_the_moment
chocolate ice cream	enjoy_the_moment
place	enjoy_the_moment
clothes	enjoy_the_moment
years	enjoy_the_moment
fried chicken	enjoy_the_moment
movement	enjoy_the_moment
chocolate cake	enjoy_the_moment
nitrogen ice cream	enjoy_the_moment
food restaurant	enjoy_the_moment
mood	enjoy_the_moment
rest	enjoy_the_moment
tea	enjoy_the_moment
made pizza	enjoy_the_moment
cheese pizza	enjoy_the_moment
yard work	enjoy_the_moment
fried	enjoy_the_moment
type	enjoy_the_moment
drive	enjoy_the_moment
moments	enjoy_the_moment
cream cheese	enjoy_the_moment
chocolate	enjoy_the_moment
food shopping	enjoy_the_moment
coffee place	enjoy_the_moment
life	enjoy_the_moment
months	enjoy_the_moment
birthday	enjoy_the_moment
junk food	enjoy_the_moment
memories	enjoy_the_moment
birthday cake	enjoy_the_moment
color	enjoy_the_moment
yesterday	enjoy_the_moment
day school	enjoy_the_moment
relaxing	enjoy_the_moment
scores	enjoy_the_moment
song	enjoy_the_moment
age home	enjoy_the_moment
book	enjoy_the_moment
events	enjoy_the_moment
ate chicken	enjoy_the_moment
tears	enjoy_the_moment
way	enjoy_the_moment
home	enjoy_the_moment
week made	enjoy_the_moment
slice	enjoy_the_moment
vacation	enjoy_the_moment
states	enjoy_the_moment
steak	enjoy_the_moment
tv show	enjoy_the_moment
dream	enjoy_the_moment
ice	enjoy_the_moment
cream	enjoy_the_moment
pepperoni	enjoy_the_moment
vacation day	enjoy_the_moment
cup	enjoy_the_moment
tacos	enjoy_the_moment
weather	enjoy_the_moment
made pork chops	enjoy_the_moment
going	enjoy_the_moment
laugh	enjoy_the_moment
start	enjoy_the_moment
sub shop	enjoy_the_moment
eating cereal	enjoy_the_moment
event	enjoy_the_moment
ate	enjoy_the_moment
grocery shopping	enjoy_the_moment
day weekend	enjoy_the_moment
feeling	enjoy_the_moment
bar	enjoy_the_moment
steak dinner	enjoy_the_moment
occasion event	enjoy_the_moment
show	enjoy_the_moment
albums	enjoy_the_moment
wine	enjoy_the_moment
thing	enjoy_the_moment
band	enjoy_the_moment
candy	enjoy_the_moment
donut	enjoy_the_moment
dish	enjoy_the_moment
brunch food	enjoy_the_moment
kind	enjoy_the_moment
treats	enjoy_the_moment
bakery	enjoy_the_moment
character	enjoy_the_moment
cafe	enjoy_the_moment
soda	enjoy_the_moment
pie	enjoy_the_moment
food items	enjoy_the_moment
author	enjoy_the_moment
home cooked meal	enjoy_the_moment
home cookies	enjoy_the_moment
day week	enjoy_the_moment
mail	enjoy_the_moment
dinner event	enjoy_the_moment
samples	enjoy_the_moment
work week	enjoy_the_moment
go	enjoy_the_moment
surprise	enjoy_the_moment
cheat day	enjoy_the_moment
morning sex	enjoy_the_moment
day today	enjoy_the_moment
night time	enjoy_the_moment
groceries	enjoy_the_moment
books	enjoy_the_moment
dinner time	enjoy_the_moment
getting released form	enjoy_the_moment
months night	enjoy_the_moment
beers	enjoy_the_moment
memory	enjoy_the_moment
traffic	enjoy_the_moment
morning coffee	enjoy_the_moment
summer days	enjoy_the_moment
luck	enjoy_the_moment
jobs	enjoy_the_moment
wings	enjoy_the_moment
burger	enjoy_the_moment
wedding	enjoy_the_moment
pay	enjoy_the_moment
incentive	enjoy_the_moment
knowing	enjoy_the_moment
pictures	enjoy_the_moment
nutrition	enjoy_the_moment
hair	enjoy_the_moment
end day	enjoy_the_moment
world	enjoy_the_moment
middle day	enjoy_the_moment
reviews	enjoy_the_moment
day shift	enjoy_the_moment
night match	enjoy_the_moment
bed	enjoy_the_moment
time work	enjoy_the_moment
movie	enjoy_the_moment
occasion	enjoy_the_moment
summer vacation	enjoy_the_moment
moods	enjoy_the_moment
cheat days	enjoy_the_moment
hockey team	enjoy_the_moment
day match	enjoy_the_moment
while	enjoy_the_moment
conversation	enjoy_the_moment
photos	enjoy_the_moment
hours	enjoy_the_moment
vacation days	enjoy_the_moment
salary	enjoy_the_moment
plays	enjoy_the_moment
store	enjoy_the_moment
soundtracks	enjoy_the_moment
terms	enjoy_the_moment
relationship	enjoy_the_moment
values	enjoy_the_moment
shape	enjoy_the_moment
artists	enjoy_the_moment
chocolate chip cookies	enjoy_the_moment
strawberry ice cream	enjoy_the_moment
sentence	enjoy_the_moment
lifestyle	enjoy_the_moment
mothers weekend	enjoy_the_moment
rain	enjoy_the_moment
piece	enjoy_the_moment
chicken	enjoy_the_moment
enjoyed	enjoy_the_moment
bicycle	enjoy_the_moment
catered lunch	enjoy_the_moment
cream ice cream	enjoy_the_moment
coffee time	enjoy_the_moment
recipe	enjoy_the_moment
couple days	enjoy_the_moment
release day	enjoy_the_moment
- day	enjoy_the_moment
school	enjoy_the_moment
drinks	enjoy_the_moment
chocolate brownies	enjoy_the_moment
relaxing moment	enjoy_the_moment
sushi restaurant	enjoy_the_moment
bargain prices	enjoy_the_moment
opening day baseball	enjoy_the_moment
minutes	enjoy_the_moment
sex life	enjoy_the_moment
opening day	enjoy_the_moment
college days	enjoy_the_moment
sale	enjoy_the_moment
haircut	enjoy_the_moment
album	enjoy_the_moment
day move	enjoy_the_moment
feel	enjoy_the_moment
temple	enjoy_the_moment
embarkation day	enjoy_the_moment
home made pizza	enjoy_the_moment
dress	enjoy_the_moment
students	enjoy_the_moment
journals	enjoy_the_moment
travelling day	enjoy_the_moment
experience	enjoy_the_moment
work place	enjoy_the_moment
night sleep	enjoy_the_moment
work kit	enjoy_the_moment
homes	enjoy_the_moment
backpack	enjoy_the_moment
burrito	enjoy_the_moment
state holiday	enjoy_the_moment
chicken strips	enjoy_the_moment
vacation time	enjoy_the_moment
chocolate chip ice cream	enjoy_the_moment
flowers	enjoy_the_moment
grocery store	enjoy_the_moment
barbecue food	enjoy_the_moment
dresses	enjoy_the_moment
night shopping event	enjoy_the_moment
chickens	enjoy_the_moment
lunch bag	enjoy_the_moment
shoes	enjoy_the_moment
areas	enjoy_the_moment
today	enjoy_the_moment
musicians	enjoy_the_moment
covers	enjoy_the_moment
ice beer	enjoy_the_moment
home made burgers	enjoy_the_moment
opening	enjoy_the_moment
eating place	enjoy_the_moment
clients	enjoy_the_moment
countertops	enjoy_the_moment
evening meal	enjoy_the_moment
lunch break	enjoy_the_moment
made breakfast	enjoy_the_moment
night rest	enjoy_the_moment
lunch place	enjoy_the_moment
summer time	enjoy_the_moment
shower	enjoy_the_moment
pretzel cookie dough	enjoy_the_moment
ice cream slushies	enjoy_the_moment
coffee eating breakfast	enjoy_the_moment
dinner food	enjoy_the_moment
hour menu	enjoy_the_moment
evening	enjoy_the_moment
party	enjoy_the_moment
time event occasion	enjoy_the_moment
smile	enjoy_the_moment
coconut flavor coffee	enjoy_the_moment
pasta dinner	enjoy_the_moment
train	enjoy_the_moment
lunch hour	enjoy_the_moment
shows	enjoy_the_moment
pc parts	enjoy_the_moment
food truck	enjoy_the_moment
breakfast foods	enjoy_the_moment
lot	enjoy_the_moment
games	enjoy_the_moment
hour	enjoy_the_moment
patio furniture	enjoy_the_moment
can eat restaurant	enjoy_the_moment
smoothie	enjoy_the_moment
fall	enjoy_the_moment
happiness	enjoy_the_moment
pros	enjoy_the_moment
summer nights	enjoy_the_moment
pizza week	enjoy_the_moment
town	enjoy_the_moment
wait time	enjoy_the_moment
evening time	enjoy_the_moment
quitting time	enjoy_the_moment
dishes	enjoy_the_moment
dogs	enjoy_the_moment
dog food samples	enjoy_the_moment
television show	enjoy_the_moment
face pack kit	enjoy_the_moment
socks	enjoy_the_moment
vanilla ice cream	enjoy_the_moment
chocolate sundae ice cream	enjoy_the_moment
breakfast sandwich	enjoy_the_moment
occasions	enjoy_the_moment
pizza shop	enjoy_the_moment
childhood	enjoy_the_moment
bowl	enjoy_the_moment
posts	enjoy_the_moment
post exercise	enjoy_the_moment
fried rice dinner	enjoy_the_moment
ending	enjoy_the_moment
flavor ice cream	enjoy_the_moment
wallpaper	enjoy_the_moment
tune	enjoy_the_moment
thinking	enjoy_the_moment
living situation	enjoy_the_moment
variety foods	enjoy_the_moment
day party	enjoy_the_moment
meals	enjoy_the_moment
ice cream shop	enjoy_the_moment
ice cream treat	enjoy_the_moment
ice cream bars	enjoy_the_moment
food restaurants	enjoy_the_moment
work travel	enjoy_the_moment
dessert	enjoy_the_moment
day work week	enjoy_the_moment
ice cream snacks	enjoy_the_moment
coffees	enjoy_the_moment
ice cream cone	enjoy_the_moment
sheets	enjoy_the_moment
coffee cake	enjoy_the_moment
cooked food	enjoy_the_moment
snack	enjoy_the_moment
ice cream place	enjoy_the_moment
strength	enjoy_the_moment
couple weeks	enjoy_the_moment
having breakfast	enjoy_the_moment
day meals	enjoy_the_moment
benches	enjoy_the_moment
lambs	enjoy_the_moment
sound sleep	enjoy_the_moment
exam time table	enjoy_the_moment
bonus adult time	enjoy_the_moment
brew coffee	enjoy_the_moment
cheeseburger	enjoy_the_moment
meal pizza	enjoy_the_moment
foods	enjoy_the_moment
home cooked dinner	enjoy_the_moment
food place	enjoy_the_moment
hamburger	enjoy_the_moment
coming summer	enjoy_the_moment
chocolate chocolate chip cookies	enjoy_the_moment
coffee grounds	enjoy_the_moment
office	enjoy_the_moment
burgers	enjoy_the_moment
cookbook	enjoy_the_moment
dish pizza	enjoy_the_moment
cocoa	enjoy_the_moment
artist	enjoy_the_moment
pizza restaurant	enjoy_the_moment
hotel	enjoy_the_moment
chicken sandwich	enjoy_the_moment
coffee ritual	enjoy_the_moment
tea brands	enjoy_the_moment
school moment	enjoy_the_moment
food dish	enjoy_the_moment
ice cream flavors	enjoy_the_moment
coffee mug	enjoy_the_moment
ice cream brand	enjoy_the_moment
cookie ice cream	enjoy_the_moment
work wine	enjoy_the_moment
seafood dinners	enjoy_the_moment
pizza chain	enjoy_the_moment
hour day	enjoy_the_moment
climate	enjoy_the_moment
breakfast restaurant	enjoy_the_moment
ice cream vendor	enjoy_the_moment
eating habits	enjoy_the_moment
home movies	enjoy_the_moment
eating plan	enjoy_the_moment
spending time	enjoy_the_moment
fruits	enjoy_the_moment
afternoon	enjoy_the_moment
ice air	enjoy_the_moment
life dream	enjoy_the_moment
wheat bread	enjoy_the_moment
construction work	enjoy_the_moment
mornings event	enjoy_the_moment
ice tea	enjoy_the_moment
sea food	enjoy_the_moment
fried chicken restaurant	enjoy_the_moment
food chain	enjoy_the_moment
week occasion event	enjoy_the_moment
launch	enjoy_the_moment
work issues	enjoy_the_moment
walk	enjoy_the_moment
water	enjoy_the_moment
book store	enjoy_the_moment
taste	enjoy_the_moment
ups	enjoy_the_moment
lunch meat	enjoy_the_moment
morning sickness	enjoy_the_moment
food poisoning	enjoy_the_moment
year dinner	enjoy_the_moment
comfort foods	enjoy_the_moment
home office	enjoy_the_moment
fish restaurant	enjoy_the_moment
cars	enjoy_the_moment
chicken wings	enjoy_the_moment
hour night	enjoy_the_moment
finals week	enjoy_the_moment
food day	enjoy_the_moment
breakfast place	enjoy_the_moment
possibilities	enjoy_the_moment
coffee drink	enjoy_the_moment
period	enjoy_the_moment
quality food	enjoy_the_moment
ice creme	enjoy_the_moment
sea food beer	enjoy_the_moment
family life	enjoy_the_moment
tv shows	enjoy_the_moment
line	enjoy_the_moment
pizza leftover	enjoy_the_moment
fish sandwich	enjoy_the_moment
buffet restaurant	enjoy_the_moment
diet	enjoy_the_moment
sleep schedule	enjoy_the_moment
mashed potatoes	enjoy_the_moment
designed saree collection	enjoy_the_moment
laughs	enjoy_the_moment
day life	enjoy_the_moment
cookies	enjoy_the_moment
day parties	enjoy_the_moment
food ice cream	enjoy_the_moment
restaurants	enjoy_the_moment
drinking coffee	enjoy_the_moment
chip ice cream	enjoy_the_moment
rice pudding	enjoy_the_moment
things fruits	enjoy_the_moment
flavor coffee	enjoy_the_moment
breakfast cereal	enjoy_the_moment
work schedules	enjoy_the_moment
options	enjoy_the_moment
chicken lunch	enjoy_the_moment
raspberry ice cream	enjoy_the_moment
chocolate bars	enjoy_the_moment
grilled cheese sandwich	enjoy_the_moment
nap	enjoy_the_moment
prices	enjoy_the_moment
spaghetti dinner	enjoy_the_moment
summer day	enjoy_the_moment
may life	enjoy_the_moment
music venue	enjoy_the_moment
burger restaurant	enjoy_the_moment
work night	enjoy_the_moment
middle night	enjoy_the_moment
appetizer	enjoy_the_moment
ice water	enjoy_the_moment
cricket team	enjoy_the_moment
shift work	enjoy_the_moment
soup	enjoy_the_moment
sport team	enjoy_the_moment
school life	enjoy_the_moment
school fun day	enjoy_the_moment
prizes	enjoy_the_moment
chicken restaurant	enjoy_the_moment
church	enjoy_the_moment
mango ice cream bubble tea	enjoy_the_moment
pm night	enjoy_the_moment
food cooking recipes	enjoy_the_moment
ice cake	enjoy_the_moment
basketball game	enjoy_the_moment
protein pancakes	enjoy_the_moment
tv dinner food	enjoy_the_moment
soccer team	enjoy_the_moment
burger joint	enjoy_the_moment
trip	enjoy_the_moment
picture	enjoy_the_moment
couple	enjoy_the_moment
pizza slices	enjoy_the_moment
football team	enjoy_the_moment
rabbit	enjoy_the_moment
workout	exercise
workouts	exercise
workout soreness	exercise
morning	exercise
exercise	exercise
workout gym	exercise
miles	exercise
morning gym class	exercise
gym session	exercise
yoga exercises	exercise
yoga workout	exercise
gym	exercise
form	exercise
jogging	exercise
morning workout	exercise
workout tips	exercise
mile time	exercise
workout session	exercise
cardio workout	exercise
time	exercise
records	exercise
gym membership	exercise
workout program	exercise
gym progress	exercise
neighborhood gym	exercise
workout plan	exercise
gym group	exercise
gym visit	exercise
climbing gym	exercise
gym staff	exercise
gym clothes	exercise
rock gym	exercise
gym buddy	exercise
gym bag	exercise
gym challenge	exercise
weight workout	exercise
shape	exercise
workout class	exercise
yoga	exercise
scenery	exercise
yoga practice	exercise
ease	exercise
mile run	exercise
workout routine	exercise
morning run	exercise
push workout	exercise
workout routines	exercise
leg workout	exercise
boxing workout	exercise
workout schedule	exercise
run	exercise
days workout	exercise
workout injury	exercise
week	exercise
workout video	exercise
piyo workouts	exercise
bicep workout	exercise
workout partner	exercise
satisfying workout	exercise
team workout	exercise
workout intensity	exercise
bodypump workout	exercise
ab workout	exercise
weight	exercise
things	exercise
mile jog	exercise
routine	exercise
day yoga class training program	exercise
bike	exercise
day yoga class event	exercise
month	exercise
feeling workout	exercise
leg day	exercise
starting phase	exercise
gym days	exercise
run time	exercise
bike ride	exercise
yoga session	exercise
yoga class	exercise
night	exercise
yoga classes	exercise
day	exercise
hour workout	exercise
gyms swimming pool	exercise
distance run	exercise
mile	exercise
minute mile	exercise
class	exercise
hour yoga class program	exercise
walk mile	exercise
time goals	exercise
day yoga event	exercise
training session	exercise
morning walk	exercise
exercise program	exercise
work	exercise
weight lifting	exercise
morning air	exercise
couple miles	exercise
aerobics classes	exercise
weight loss	exercise
classes	exercise
mile pace	exercise
revitalizing workout	exercise
session	exercise
muscle	exercise
walk	exercise
minute workout	exercise
mile bike ride	exercise
jog	exercise
push ups	exercise
squat record	exercise
workout sessions	exercise
progress	exercise
summer	exercise
exercising	exercise
sweat	exercise
mood	exercise
mile road bike ride	exercise
energy	exercise
morning jog	exercise
running partners	exercise
gym weeks	exercise
gym hours	exercise
trainer	exercise
tempo run	exercise
stress feeling	exercise
exercise bike	exercise
max	exercise
workout days	exercise
weather	exercise
gym days row	exercise
exercise routine	exercise
bouldering problems	exercise
months	exercise
work day	exercise
people	exercise
lifting record	exercise
mile ride	exercise
place	exercise
repetitions	exercise
exercise routines	exercise
work tasks	exercise
hike	exercise
goal	exercise
exercise goal	exercise
yoga teacher	exercise
achievement	exercise
pace time	exercise
yoga mantra	exercise
yoga movements	exercise
mile walk	exercise
yoga camp	exercise
day fitness event	exercise
yoga guru	exercise
yoga stretches	exercise
song	exercise
record time	exercise
membership	exercise
nights sleep	exercise
mile race	exercise
days	exercise
mile fun	exercise
shuffle	exercise
battle ropes	exercise
exercise schedule	exercise
hour yoga session	exercise
bench press weight	exercise
route	exercise
mountain bike ride	exercise
self esteem	exercise
phase	exercise
habit	exercise
training	exercise
headphones	exercise
nikes	exercise
body	exercise
exercise regime	exercise
workout diet meal prep schedule	exercise
moment	exercise
calisthenics exercises	exercise
strength training	exercise
hit records	exercise
cardio	exercise
yoga meditation class	exercise
instructor	exercise
muscles	exercise
podcast	exercise
minute yoga flow	exercise
prayer session	exercise
leg lifts	exercise
distance	exercise
weeks	exercise
weight side	exercise
lots	exercise
weights	exercise
duration	exercise
layoff	exercise
bar squat	exercise
couple weeks	exercise
vacation	exercise
minutes morning	exercise
machines	exercise
fitness goal	exercise
record	exercise
pack exercise routines	exercise
weight set	exercise
designated weight	exercise
pilates class	exercise
injury	exercise
experience	exercise
city park	exercise
minutes	exercise
work session	exercise
artists	exercise
parkour visions gym	exercise
sports bike	exercise
trend practice	exercise
shower	exercise
mind	exercise
legs	exercise
mind tension	exercise
depression	exercise
squats	exercise
diet changes	exercise
couple days	exercise
day guest pass	exercise
evening	exercise
intensity interval training	exercise
hour	exercise
bicycle ride	exercise
ride	exercise
ability	exercise
minute	exercise
park	exercise
water	exercise
swimming pool	exercise
stress	exercise
glass	exercise
instinct players	exercise
students	exercise
work outs	exercise
bench press plateau	exercise
air	exercise
protein shake	exercise
soccer	exercise
home	exercise
friends	exercise
changes	exercise
improvement	exercise
places	exercise
spring evening	exercise
music	exercise
years	exercise
tennis	exercise
energy music	exercise
swimming	exercise
hour walk	exercise
center	exercise
muscle pump	exercise
diving students	exercise
day row	exercise
patients	exercise
cycling class	exercise
rests	exercise
shoulders	exercise
cardio circuit strength training	exercise
lift	exercise
days row	exercise
break	exercise
played volleyball	exercise
neighborhood park	exercise
pain	exercise
lunch	exercise
volleyball	exercise
thighs	exercise
library	exercise
building muscle	exercise
muscle soreness	exercise
training plan	exercise
town	exercise
weekend	exercise
parking lot	exercise
hours	exercise
chocolate milk	exercise
results	exercise
stretch	exercise
protein diet	exercise
weather forecast	exercise
drawings	exercise
fitness progress	exercise
girl	exercise
yoga meditation	exercise
rain	exercise
muscle ups	exercise
sports	exercise
state	exercise
reduction	exercise
speed	exercise
year	exercise
exerting work	exercise
community sports event	exercise
track	exercise
climbing	exercise
minute half	exercise
boxing	exercise
level	exercise
bus disappearing form	exercise
jelly doughnut	exercise
costume drawing workshop	exercise
order	exercise
pool	exercise
self improvement	exercise
fitness competition	exercise
basketball	exercise
squat ups	exercise
woman	exercise
home state	exercise
chapters	exercise
round	exercise
treadmill	exercise
strategy	exercise
couple months	exercise
hour half	exercise
hill	exercise
starting	exercise
ace	exercise
dumbbells	exercise
puppy wandering	exercise
street run	exercise
feeling	exercise
bench	exercise
track race	exercise
care	exercise
pump	exercise
meditation	exercise
arms	exercise
toad	exercise
happiness advantage	exercise
city	exercise
string	exercise
event	exercise
basis	exercise
mud	exercise
soccer match	exercise
teacher	exercise
study	exercise
strengthening program	exercise
bcaa supplement	exercise
interest	exercise
part	exercise
bed	exercise
endorphins	exercise
stomach flu	exercise
running	exercise
campus	exercise
blood	exercise
attended	exercise
girls number	exercise
date	exercise
effect	exercise
butt	exercise
purpose	exercise
surgery	exercise
school	exercise
dedication	exercise
art equipment	exercise
powder	exercise
butterflies	exercise
path	exercise
deadlifts	exercise
pounds	exercise
trail route	exercise
neighborhood	exercise
milf	exercise
mp3 cable	exercise
excercises	exercise
may	exercise
strain	exercise
standards	exercise
pace	exercise
view	exercise
truck	exercise
guilt	exercise
breath	exercise
satisfaction	exercise
nap	exercise
turtles	exercise
speaker system	exercise
settings	exercise
while	exercise
fact	exercise
nationals	exercise
deer	exercise
race	exercise
effort	exercise
compliments	exercise
mirror reflection	exercise
got	exercise
dinner	exercise
stuff	exercise
worked	exercise
finish	exercise
past teammates	exercise
ran	exercise
puppy	exercise
racing	exercise
college	exercise
pose	exercise
step	exercise
audiobook	exercise
basketball court	exercise
reps pound dumbbells	exercise
practices meditation	exercise
schedule	exercise
definition	exercise
strength	exercise
adrenaline rush	exercise
high	exercise
fit	exercise
chin ups	exercise
half	exercise
street	exercise
self	exercise
discharge	exercise
rowing machine	exercise
trip	exercise
trail	exercise
felt	exercise
bicycle	exercise
met	exercise
beginning	exercise
size	exercise
happiness	exercise
groups	exercise
illness	exercise
student	exercise
lunchtime	exercise
kilometer race	exercise
problems	exercise
beach	exercise
sun	exercise
lifts	exercise
dollar bill	exercise
dog	exercise
medication	exercise
fools run	exercise
rest	exercise
river	exercise
dollar	exercise
love	exercise
forecast	exercise
mirror	exercise
bus	exercise
steps	exercise
valley	exercise
knees	exercise
confidence	exercise
hint	exercise
power cage	exercise
back	exercise
thumb	exercise
driveway	exercise
workshop	exercise
staff	exercise
danger	exercise
past	exercise
handstand	exercise
biceps	exercise
end	exercise
poses	exercise
row	exercise
calories	exercise
bit progress	exercise
house	exercise
sets	exercise
eyes	exercise
grass	exercise
cold	exercise
capacity	exercise
kids	exercise
marathon	exercise
apartment	exercise
dominance	exercise
garage	exercise
wife	exercise
face	exercise
dawn	exercise
fear	exercise
numbers	exercise
nickel	exercise
organisation	exercise
health	exercise
teammates	exercise
floor	exercise
lake	exercise
reward	exercise
gentleman	exercise
relief	exercise
guy	exercise
